



















                      00000000001000000000000000000000000000000000000002100000
                      00000000000000000000000000000000000000000000000000000000
                      00000000000000000000000000000000000000000000000000000000
                      00000000000011111110111012111102100101011212111120000000
                      00000000000022223322323013322323301313232121333120000000
                      00000000000000110111100003301010000110101001013000000000
                      00000000000000000000000002200000000000000000000000000000
                      00000000000000000000000000000000000000000000000000000000
                      00002100000000000000000000000000000000000000000000000000
                      00003310000000000000000000000000000000000000000000000000
                      00000231000000000000000000000000000000000000000000000000
                      00000010000000000000000000000000000000000000000000000000
                      00000000000000000000000000011000000000000000000121221100
                      00000000000000000000001112223322332100000000000000000000
                      00000000000000000002333322333233223333210000000000000000
                      00000000000000000133321111132123222321333100000000000000
                      00000000000000012332111101011222221233222320000000000000
                      00000000000000133100112111113200132132222122010000000013
                      00000000000002311012111111002000220221212323320000000012
                      00000000000022111220010000110001310210112222320000000000
                      01300000000232112101000000020012222210011222233000001000
                      00100000001221111000001222111123101320010012223200000000
                      00000000002211220000022122322222211100010002121200000000
                      00000000013212000000111222222222222200000101122120000000
                      00000000022210000001222123333333322221000000113231000000
                      00000000032100000001222233333333333222210000101222000000
                      00000000023011100002312333223322333322211000000122200000
                      00000000022200100001323331221111132332222100100122200000
                      00000000121100100000223332211111133333320000100212310000
                      00000210023100100000222333322223333333320011112212310000
                      00000320013310100000023333333222013333310022222232320000
                      00000000002332221100112333322111002333310100000012030000
                      00000000001322233322222331123322232333332000010012131000
                      00000000000220001233212221321233333333333100000121231000
                      00000000000012222123333102332211122333333000000222121000
                      00000000000000123322332102323323211333332000001221231000
                      00000000000000002200032102003211111233332121122201230000
                      00000000000000000210022012123211122233332221211222320000
                      00001222122100000022223222223333333333333211100122210000
                      00000000000000000001223321223332221222233223322223200000
                      00000000000000000000011121023311133333333333333333100000
                      00000000000000000000000001122333333320011122123320000000
                      00000000000000000000000000012333212321000000002220000000
                      00000000000000100000000000000232111322100000012310000000
                      00000000000000112222100000000033122322110000012300000000
                      00200000000000000022000000000002223331000000013100000000
                      23300000000000000000000000000000111233111112232000000000
                      32000000000000000000000000000000121121233332210000000000
                      00000000000000000000000000000000021110000000000000000000
                      00000000000000000000000022212210012110000000000000000000
                      00000000000000000000000000000000002110000000000000000000
                      00000000000000001111110211111000001211000000021112220130
                      00000000000000000111110112111000000201000003200000000033
                      00000000000000000000000000000000000000000001310000000003
                      00000000000320000000000000000000000000000000200000000000
                      00000000002310000000000000000000000000000000000000000000
                      00000000003200000000000000000000000000000000000000000000
                      00000000001000000000000000000000000000000000000000000000
                      00000000000000000000000000000000000000000000000000000000
                      00000000000000000000000000031000000000000000000000000000
