00000000000000000000000000000000000000000000000
00000000000000000000110000000000000000000000000
00000000000000011122233223321000000000000000000
00000000000023333223332332233332100000000000000
00000000001333211111321232223213331000000000000
00000000123321111010112222212332223200000000000
00000001331001121111132001321322221220100000000
00000023110121111110020002202212123233200000000
00000221112200100001100013102101122223200000000
00002321121010000000200122222100112222330000000
00012211110000012221111231013200100122232000000
00022112200000221223222222111000100021212000000
00132120000001112222222222222000001011221200000
00222100000012221233333333222210000001132310000
00321000000012222333333333332222100001012220000
00230111000023123332233223333222110000001222000
00222001000013233312211111323322221001001222000
01211001000002233322111111333333200001002123100
00231001000002223333222233333333200111122123100
00133101000000233333332220133333100222222323200
00023322211001123333221110023333101000000120300
00013222333222223311233222323333320000100121310
00002200012332122213212333333333331000001212310
00000122221233331023322111223333330000002221210
00000001233223321023233232113333320000012212310
00000000022000321020032111112333321211222012300
00000000002100220121232111222333322212112223200
00000000000222232222233333333333332111001222100
00000000000012233212233322212222332233222232000
00000000000000111210233111333333333333333331000
00000000000000000011223333333200111221233200000
00000000000000000000123332123210000000022200000
00000000000000000000002321113221000000123100000
00000000000000000000000331223221100000123000000
00000000000000000000000022233310000000131000000
00000000000000000000000001112331111122320000000
00000000000000000000000001211212333322100000000
00000000000000000000000000211100000000000000000
00000000000000000000000000121100000000000000000
00000000000000000000000000021100000000000000000
00000000000000000000000000012110000000000000000
00000000000000000000000000002010000000000000000
00000000000000000000000000000000000000000000000
