444444444444444444444444444444
444444444444444444444444444444
441111111111444444411111111144
441444444441444444414444444144
441444444441444444414444444144
441441111441444444414411144144
441441441441444444414444144144
441441441441444444414444144144
441444441441444444411111144144
441444441441444444444444444144
441111111441444444444444444144
444444444441444111111111111144
444444444441444144444444444444
444444444441444144444444444444
444444444441111144444444444444
444444444444441111144444444444
444444444444441444144444444444
444444444444441444144444444444
441111111111111444144444444444
441444444444444444144111111144
441444444444444444144144444144
441441111114444444144144444144
441441444414444444144144144144
441441444414444444144144144144
441441114414444444144111144144
441444444414444444144444444144
441444444414444444144444444144
441111111114444444111111111144
444444444444444444444444444444
444444444444444444444444444444