000000000000000000000000000000000000000000000000000000000000
000000000000000000000000000000000000000000000000000000000000
000000000000000000000000000000000000000000131000001310000000
000000000000000000000000000000000000000000233000003310000000
000000000000000000000000000000000000000000231023201320000000
000000000000000000000000000000000000000000100133320010000000
000000000000000000000000000000000000000000001123311000000000
000000000000000000000000000000000000000000013423343100000000
000000000000000000000000000000000000000000111332331111000000
000000000000000000000000000000000000010000332320131331000000
000000000000000000010111100000000100001000231224221321000000
000000000000000122232333332222221111112320010144410110000000
000000000000001233332111113233333333333331100234320010000000
000000000000021332110001011222222222233332210044400100000000
000000000000233320000112222222222222112332110110001100000000
000000000000133101000001222222322223220233200100012000000000
000000000101023000100133122222232222220232112211021000000000
000000012311103110030033222221221212210231101201220000000000
000000123311103210012012312122122331111321100010200000000000
000000233112102210000001012212122221212301111011100000000000
000001233102101300011002212201111101013100001001000000000000
000000033002111310001210101220111110132000001010000000000000
000000112002002320000122210012121111330000023100000000000000
000000210011232310002001221110000013320012111000000000000000
000000000021223100021000001111000022310122101000000000000000
000000000111131001220000000000000022210111002000000000000000
000000012122001221000000000000000021210000012000000000000000
000001222210012310000000000000000021210001112000000000000000
000001333100233200000000000000000022210000322000000000000000
000001331000023100000000000000000023310000233000000000000000
000001220000012200000000000000000033300000233100000000000000
000000231000002320000000000000000023300000023200000000000000
000001332000000444400000000000000012310000002320000000000000
000004444000000000000000000000000002300000001333000000000000
000000000000000000000000000000000002333100000444400000000000
000000000000000000000000000000000004444000000000000000000000
000000000000000000000000000000000000000000000000000000000000
000000000000000000000000000000000000000000000000000000000000