0000000000000000000000000000000000000000000000000
0000000000000000000000000000000000000000000000000
0000000000000000000000000000000000000131000001310
0000000000000000000000000000000000000233000003310
0000000000000000000000000000000000000231023201320
0000000000000000000000000000000000000100133320010
0000000000000000000000000000000000000001123311000
0000000000000000000000000000000000000013423343100
0000000000000000000000000000000000000111332331111
0000000000000000000000000000000010000332320131331
0000000000000010111100000000100001000231224221321
0000000000122232333332222221111112320010144410110
0000000001233332111113233333333333331100234320010
0000000021332110001011222222222233332210044400100
0000000233320000112222222222222112332110110001100
0000000133101000001222222322223220233200100012000
0000101023000100133122222232222220232112211021000
0012311103110030033222221221212210231101201220000
0123311103210012012312122122331111321100010200000
0233112102210000001012212122221212301111011100000
1233102101300011002212201111101013100001001000000
0033002111310001210101220111110132000001010000000
0112002002320000122210012121111330000023100000000
0210011232310002001221110000013320012111000000000
0000021223100021000001111000022310122101000000000
0000111131001220000000000000022210111002000000000
0012122001221000000000000000021210000012000000000
1222210012310000000000000000021210001112000000000
1333100233200000000000000000022210000322000000000
1331000023100000000000000000023310000233000000000
1220000012200000000000000000033300000233100000000
0231000002320000000000000000023300000023200000000
1332000000444400000000000000012310000002320000000
4444000000000000000000000000002300000001333000000
0000000000000000000000000000002333100000444400000
0000000000000000000000000000004444000000000000000
0000000000000000000000000000000000000000000000000
0000000000000000000000000000000000000000000000000
