0000000000000000000000000000000000000000
0000000000000000000000000000000000000000
0000000000000000000000000000000000000000
0000000000000000000000000000000000000000
0000000000000000000000000000000000000000
0000000000000000000000000000000000000000
0000000000000000000000000000000000000000
0000000000000000001222100000000000000000
0000000000000000012233320000000000000000
0000000000000000022233331000000000000000
0000000000000000122232232000000000000000
0000000000000000124122432000000000000000
0000000000000004122223232400000000000000
0000000000000000122243332000000000000000
0000000000000000122223322000000000000000
0000000000000000122223231000000000000000
0000000000000000022444321000000000000000
0000000000000000012223320000000000000000
0000000000000000011222210000000000000000
0000000000000000011222110000000000000000
0000000000000000011222111000000000000000
0000000000000000111223111100000000000000
0000000000000111101223211111110000000000
0000000000111212222222222222221000000000
0000000001122211222232222112222100000000
0000000011222222222232222222232110000000
0000000011121222222232222222122110000000
0000000011120122222232222221022110000000
0000000011120022222232222221022010000000
0000000011221122222233323321122010000000
0000000011211122222233333331112110000000
0000000011210122122232333122112110000000
0000000011211122223232232222112110000000
0000000011211221122232222122202110000000
0000000011201222221232123332202110000000
0000000011201221221232113222102111000000
0000000112211122210232112332102211000000
0000000112211122201232101222001311000000
0000000122211122111232110232012321000000
0000000122210121110222001121012221100000
0000001122110111101222111111011221100000
0000001122010111100111111112010221100000
0000001222010111111111111111111122100000
0000001221010111111111111111101122100000
0000001221000122212222211221001122100000
0000001221100133222222222232001012200000
0000002211000123222222222231000112200000
0000002210001113322222222221100011200000
0000002210001102332222222211100011210000
0000012210001102321222112201100012210000
0000022210001102211222102210100012220000
0001222210001122222222112221100002222100
0012222210001222222121222222100002222210
0021122210001221122222221122100002221120
0311212210001221012222220022100012211113
0001222210001220001111100022100012221200
0002121210001220000111000022100012121210
0011121110001121001111100022110011111110
0011111130001121000111100121110031111030
0030113000001122000111100121100000311000
0000300000001122000111100121100000003000
0000000000001122000111100220100000000000
0000000000001112000111100221100000000000
0000000000001112100111000211100000000000
0000000000001112100111101211100000000000
0000000000000112200111101211000000000000
0000000000000112201111102211000000000000
0000000000000112201111002211000000000000
0000000000000012210111012211000000000000
0000000000000012222101122210000000000000
0000000000000012222101222210000000000000
0000000000000012222101122210000000000000
0000000000000012222101222210000000000000
0000000000000012221100122210000000000000
0000000000000011221100122110000000000000
0000000000000011221101012110000000000000
0000000000000011220101012110000000000000
0000000000000011220101022110000000000000
0000000000000011221101022110000000000000
0000000000000011121101022110000000000000
0000000000000011121101022110000000000000
0000000000000011121101022110000000000000
0000000000000001121100122100000000000000
0000000000000001121100122100000000000000
0000000000000001121000122100000000000000
0000000000000001121000122100000000000000
0000000000000000121000122000000000000000
0000000000000000121000122000000000000000
0000000000000000221000122000000000000000
0000000000000000222000222000000000000000
0000000000000000222101222000000000000000
0000000000000000222100222100000000000000
0000000000000001222000222100000000000000
0000000000000002222000122200000000000000
0000000000000012221000122210000000000000
0000000000000022221000022221000000000000
0000000000000122220000022221000000000000
0000000000000322220000032223000000000000
0000000000000033330000003330000000000000
0000000000000000000000000000000000000000
