             00000000000000000000000000000000000000000000000000000000000000000000000000
             00000000000000000000000000000000000000000000000000000000000000000000000000
             00000000000000000000000000000000000000000000000000000000000000000000000000
             00000000000000000000000000000000000000000000000000000000000000000000000000
             00000000000000000000000000000000000122210000000000000000000000000000000000
             00000000000000000000000000000000001223332000000000000000000000000000000000
             00000000000000000000000000000000002223333100000000000000000000000000000000
             00000000000000000000000000000000012223223200000000000000000000000000000000
             00000000000000000000000000000000012412243200000000000000000000000000000000
             00000000000000000000000000000000012222323200000000000000000000000000000000
             00000000000000000000000000000000012224333200000000000000000000000000000000
             00000000000000000000000000000000012222332200000000000000000000000000000000
             00000000000000000000000000000000012222323100000000000000000000000000000000
             00000000000000000000000000000000002244432100000000000000000000000000000000
             00000000000000000000000000000000001222332000000000000000000000000000000000
             00000000000000000000000000000000001122221000000000000000000000000000000000
             00000000000000000000000000000000001122211000000000000000000000000000000000
             00000000000000000000000000000000001122211100000000000000000000000000000000
             00000000000000000000000000000000011122311110000000000000000000000000000000
             00000000000000000000000000000011110122321111111000000000000000000000000000
             00000000000000000000000000011121222222222222222100000000000000000000000000
             00000000000000000000000000112221122223222211222210000000000000000000000000
             00000000000000000000000001122222222223222222223211000000000000000000000000
             00000000000000000000000001112122222223222222212211000000000000000000000000
             00000000000000000000000001112012222223222222102211000000000000000000000000
             00000000000000000000000001112002222223222222102201000000000000000000000000
             00000000000000000000000001122112222223222222112201000000000000000000000000
             00000000000000000000000001121112222223222233111211000000000000000000000000
             00000000000000000000000001121012212223222212211211000000000000000000000000
             00000000000000000000000001121112222323223222211211000000000000000000000000
             00000000000000000000000001121122112223222212220211000000000000000000000000
             00000000000000000000000001120122222123212333220211000000000000000000000000
             00000000000000000000000001120122122123211322210211100000000000000000000000
             00000000000000000000000011221112221023211233210221100000000000000000000000
             00000000000000000000000011221112220123210122200131100000000000000000000000
             00000000000000000000000012221112211123211023201232100000000000000000000000
             00000000000000000000000012221012111022200112101222110000000000000000000000
             00000000000000000000000112211011110122210111101122110000000000000000000000
             00000000000000000000000112201011110022210111201022110000000000000000000000
             00000000000000000000000122201011110122210001111112210000000000000000000000
             00000000000000000000000122101011000022210000110112210000000000000000000000
             00000000000000000000000122100012221222221122100112210000000000000000000000
             00000000000000000000000122110013322222222223200101220000000000000000000000
             00000000000000000000000221100012322222222223100011220000000000000000000000
             00000000000000000000000221000111332222222222110001120000000000000000000000
             00000000000000000000000221000110233222222221110001121000000000000000000000
             00000000000000000000001221000110232122211220110001221000000000000000000000
             00000000000000000000002221000110221122210221010001222000000000000000000000
             00000000000000000000122221000112222222211222110000222210000000000000000000
             00000000000000000001222221000122222212122222210000222221000000000000000000
             00000000000000000002112221000122112222222112210000222112000000000000000000
             00000000000000000031121221000122101222222002210001221111300000000000000000
             00000000000000000000122221000122000111110002210001222120000000000000000000
             00000000000000000000212121000122000011100002210001212121000000000000000000
             00000000000000000001112111000112100111110002211001111111000000000000000000
             00000000000000000001111113000112100011110012111003111103000000000000000000
             00000000000000000003011300000112200011110012110000031100000000000000000000
             00000000000000000000030000000112200011110012110000000300000000000000000000
             00000000000000000000000000000112200011110022010000000000000000000000000000
             00000000000000000000000000000111200011110022110000000000000000000000000000
             00000000000000000000000000000111210011100021110000000000000000000000000000
             00000000000000000000000000000111210011110121110000000000000000000000000000
             00000000000000000000000000000011220011110121100000000000000000000000000000
             00000000000000000000000000000011220111110221100000000000000000000000000000
             00000000000000000000000000000011220111100221100000000000000000000000000000
             00000000000000000000000000000001221011101221100000000000000000000000000000
             00000000000000000000000000000001222210112221000000000000000000000000000000
             00000000000000000000000000000001222210122221000000000000000000000000000000
             00000000000000000000000000000001222210112221000000000000000000000000000000
             00000000000000000000000000000001222210122221000000000000000000000000000000
             00000000000000000000000000000001222110012221000000000000000000000000000000
             00000000000000000000000000000001122110012211000000000000000000000000000000
             00000000000000000000000000000001122110101211000000000000000000000000000000
             00000000000000000000000000000001122010101211000000000000000000000000000000
             00000000000000000000000000000001122010102211000000000000000000000000000000
             00000000000000000000000000000001122110102211000000000000000000000000000000
             00000000000000000000000000000001112110102211000000000000000000000000000000
             00000000000000000000000000000001112110102211000000000000000000000000000000
             00000000000000000000000000000001112110102211000000000000000000000000000000
             00000000000000000000000000000000112110012210000000000000000000000000000000
             00000000000000000000000000000000112110012210000000000000000000000000000000
             00000000000000000000000000000000112100012210000000000000000000000000000000
             00000000000000000000000000000000112100012210000000000000000000000000000000
             00000000000000000000000000000000012100012200000000000000000000000000000000
             00000000000000000000000000000000012100012200000000000000000000000000000000
             00000000000000000000000000000000022100012200000000000000000000000000000000
             00000000000000000000000000000000022200022200000000000000000000000000000000
             00000000000000000000000000000000022210122200000000000000000000000000000000
             00000000000000000000000000000000022210022210000000000000000000000000000000
             00000000000000000000000000000000122200022210000000000000000000000000000000
             00000000000000000000000000000000222200012220000000000000000000000000000000
             00000000000000000000000000000001222100012221000000000000000000000000000000
             00000000000000000000000000000002222100002222100000000000000000000000000000
             00000000000000000000000000000012222000002222100000000000000000000000000000
             00000000000000000000000000000032222000003222300000000000000000000000000000
             00000000000000000000000000000003333000000333000000000000000000000000000000
             00000000000000000000000000000000000000000000000000000000000000000000000000
             00000000000000000000000000000000000000000000000000000000000000000000000000
             00000000000000000000000000000000000000000000000000000000000000000000000000
             00000000000000000000000000000000000000000000000000000000000000000000000000
