0000000000000000000000000000000000000000000000000000000000000000
0000000000000000000000000000000000000000000000000000000000000000
0000000000000000000000000000000000000000000000000000000000000000
0000000000000000000000000000000000000000000000000000000000000000
0000000000000000000000000000000000000000000000000000000000000000
0000000000000000000000000000000000000000000000000000000000000000
0000000000000000000000000000000000000000000000000000000000000000
0000000000000000000000000000000000000000000000000000000000000000
0000000000000000000000000000000000000000000000000000000000000000
0000000000000000000000000000000000000000000000000000000000000000
0000000000000000000000000000000000000000000000000000000000000000
0000000000000000000000000000000000000000000000000000000000000000
0000000000000000000000000000000000000000000000000000000000000000
0000000000000000000000000000000000000000000000000000000000000000
0000000000000000000000000000000000000000000000000000000000000000
0000000000000000000000000000000000000000000000000000000000000000
0000000000000000000044444444444444444444444444440000000000000000
0000000000000000000041111111111444444411111111140000000000000000
0000000000000000000041444444441444444414444444140000000000000000
0000000000000000000041444444441444444414444444140000000000000000
0000000000000000000041441111441444444414411144140000000000000000
0000000000000000000041441441441444444414444144140000000000000000
0000000000000000000041441441441444444414444144140000000000000000
0000000000000000000041444441441444444411111144140000000000000000
0000000000000000000041444441441444444444444444140000000000000000
0000000000000000000041111111441444444444444444140000000000000000
0000000000000000000044444444441444111111111111140000000000000000
0000000000000000000044444444441444144444444444440000000000000000
0000000000000000000044444444441444144444444444440000000000000000
0000000000000000000044444444441111144444444444440000000000000000
0000000000000000000044444444444441111144444444440000000000000000
0000000000000000000044444444444441444144444444440000000000000000
0000000000000000000044444444444441444144444444440000000000000000
0000000000000000000041111111111111444144444444440000000000000000
0000000000000000000041444444444444444144111111140000000000000000
0000000000000000000041444444444444444144144444140000000000000000
0000000000000000000041441111114444444144144444140000000000000000
0000000000000000000041441444414444444144144144140000000000000000
0000000000000000000041441444414444444144144144140000000000000000
0000000000000000000041441114414444444144111144140000000000000000
0000000000000000000041444444414444444144444444140000000000000000
0000000000000000000041444444414444444144444444140000000000000000
0000000000000000000041111111114444444111111111140000000000000000
0000000000000000000044444444444444444444444444440000000000000000
0000000000000000000000000000000000000000000000000000000000000000
0000000000000000000000000000000000000000000000000000000000000000
0000000000000000000000000000000000000000000000000000000000000000
0000000000000000000000000000000000000000000000000000000000000000
0000000000000000000000000000000000000000000000000000000000000000
0000000000000000000000000000000000000000000000000000000000000000
0000000000000000000000000000000000000000000000000000000000000000
0000000000000000000000000000000000000000000000000000000000000000
0000000000000000000000000000000000000000000000000000000000000000
0000000000000000000000000000000000000000000000000000000000000000
0000000000000000000000000000000000000000000000000000000000000000
0000000000000000000000000000000000000000000000000000000000000000
0000000000000000000000000000000000000000000000000000000000000000
0000000000000000000000000000000000000000000000000000000000000000
0000000000000000000000000000000000000000000000000000000000000000
0000000000000000000000000000000000000000000000000000000000000000
0000000000000000000000000000000000000000000000000000000000000000