00000000000000000000000000000000000000000000000000000000
00000000000000000000000001110000000000000000000000000000
00000000000000000000001101111100000010000000000000000000
00000000000000000000001212111111001110000000000000000000
00000000000000000000001222211111111111100000000000000000
00000000000000000000002223221121111111100000000000000000
00000000000000000000002213321122112222100000000000000000
00000000000000000000012212322222111222000000000000000000
00000000000000000000012211233221111221000000000000000000
00000000000000000000013211123322111110000000000000000000
00000000000000000000013211122333221210000000000000000000
00000000000000000000023221123222322210000000000000000000
00000000000000000000122221122211111000000000000000000000
00000000000000000001322221133321111100000000000000000000
00000000000000000122211121233221111111000000000000000000
00000000000000002221111121133221111111100000000000000000
00000000000000122211111111133311111111110000000000000000
00000000000012322111111111122121111111111110000000000000
00000000000222211111111111122321111111111121100000000000
00000000002222222222222221122212222211222222111000000000
00000000122111122222333332111122333322221111111100000000
00000001221122111112212221222212211121011111111010000000
00000002211111111132122221122112221113111111110001000000
00000022111111111232233221111112322223200110010000000000
00000122111110012322333321011112223321210011101000100000
00000121111110013212333221011112232211121011100100100000
00000121111100023223322221011102322222231001110010000000
00000221101100122333333321011111223333321001111010000000
00000221101100132123333221011012123222113001111011000000
00000221111101233222222211010012212222232001111101000000
00000221111112323333322211001111122233322100122101110000
00001211111113321233332221001111223333202201112111100000
00001211101112321222222221001211112322112101211111110000
00001211111112233333222221001111112322333102221110000000
00001211111112223333332221001111113333321212312110000000
00000211111112222333332210010001023332212212322111000000
00001221111123233333321111011000123322233112232211000000
00002211111123223333211110011101112223321122033211000000
00002211111133212332111110011100111112211121023311000000
00012211111133222211122111113211111111022111003321100000
00022211111123123212333221113222211111331110002331100000
00122111011113222333332211113312221222211110001332100000
00222110112113221123332111113312221321021110000232110000
00222110112003222212221111113212113222221210000033110000
00221100111003321122111111112311233222211200000013211000
01221100121002321111111111100213333210211100000002211100
12121000120001321222111111122123322111111100000001211100
12111001210000321122212111222233223223211100000000111100
11111001200000221222111133333322333323311100000000011000
11110012100000221111111112222122233223201100000000001100
11100122000000221111222212212222232123211100000000000100
11100121000000321222223322322223211123201100000000000000
11101120000001321132222322323322123222101100000000000000
01111110000001321122111111111110223223101100000000000000
00111210000001312211111111111111233212001100000000000000
00111210000002311211123232222222222222000110000000000000
00001100000002311221122233222222221112000110000000000000
00001100000002211321122121112212222121000110000000000000
00001000000002211111012222221222222121000110000000000000
00000000000002221221122222231222211111000100000000000000
00000000000002221111122212221222222122001110000000000000
00000000000012221122101222222222122211001110000000000000
00000000000012211111002221221121222221001110000000000000
00000000000011111111100111221111112101000110000000000000
00000000000011111112001011121100110111000010000000000000
00000000000011111000001111111110001111000010000000000000
00000000000111111000110011111110011110000001000000000000
00000000000111111000110100010000111100000001000000000000
00000000000111111000000110011000100000000000000000000000
00000000000111100100000000110000000000000000000000000000
